Танатофобия — страх умереть.
Клаустрофобия — боязнь замкнутого пространства.
Аквафобия — боязнь воды; она угрожает каждому второму человеку, однажды столкнувшемуся с несчастным случаем на водоеме.
Офидиофобия — боязнь змей.
Арахнофобия — боязнь пауков.
Гематофобия — боязнь вида крови.
Аутофобия — панический страх остаться в одиночестве.
Ритифобия — боязнь морщин (спасибо чрезмерной популяризации инъекций ботокса).
Ойнофобия — боязнь вина.
Гетерофобия — боязнь противоположного пола
Паразитофобия — боязнь насекомых-паразитов
Радиофобия — боязнь радиации
Спидофобия — боязнь заразиться СПИДом
Тетрафобия — боязнь числа 4
Атазагорафобия — страх быть забытым или проигнорированным.
Компьютерофобия — боязнь компьютеров
Трипанофобия — страх перед уколами.
Никтофобия — страх темноты.
Коулрофобия — страх клоунов.
Черофобия — страх веселья, счастья.
Нет фобий.
Богифобия — страх призраков, духов, демонов и прочей нечисти.
Гоплофобия — боязнь, что люди с оружием могут убить друг друга.
Айлурофобия — боязнь кошек.
Акустикофобия  — боязнь громких звуков.
Антофобия — устойчивый страх перед цветами.
Астрафобия  — боязнь грома и молний.
Аэрофобия — боязнь полетов на самолетах и других летательных аппаратах.
Геронтофобия  — страх перед пожилыми людьми.
Гефирофобия — страх перед мостами.
Термофобия-боязнь жары и натопленных помещений.
Декстрофобия — боязнь вещей расположенных справа.
Нет фобий.
Айхмофобия — боязнь острых предметов.
Хроматофобия — боязнь какого-либо цвета и окрашенных в него предметов.
Зоофобия — боязнь животных.
Иофобия — боязнь ядов.
Малевзиофобия  — страх перед родами.
Погонофобия — боязнь бородатых.
Акрофо́бия — навязчивый страх высоты.
Виргинитифобия — боязнь изнасилования.